00000000000000000-
00000000000000000-
02020200000000000-
00000000000000000-
02010200000000000-
00000000000000000-
02020200000000000-
00000000000000000-
00000000000000000-
00000000000000000